**********
*P       *
*        *
*         *
*     *   *
*    *M   *
*   *     *
*        *
*       G*
**********